1111111111111111111111111111111111111111
110000000000C000000000000000000C00000001
11110000000000000000000ee000000000000001
1000000000000011110000000000000000000001
1111111111110000000000000000C00000000001
1000000000000000E0000000000000000000e001
1111110000000000000000000000000000000001
1000000000000P00000000000000000000000111
1110000000000000000000e11111100000000001
1111111111110000000000000011111111111111
1000000000000000000000000000000000000001
1111111111111111111111111111111111111111
