111111111111
1111C00000C1
100000000011
110000000111
111110000001
1111111111P1
1111111111E1
111111111111
