1111111111
100P0C0E11
111e0C0101
1111111111
